also remove image=remover a imagem também
Apply=Aplicar
Are you sure=Tem a certeza?
Cancel=Cancelar
checking=verificando
Completely REMOVE=ELIMINAR completamente
Console=Terminal
day=dia
days=dias
disk image and definition=imagem e definição do disco
Disks=Discos
Donate=Doar
Done=Feito
Edit=Editar
Execution error=Erro de execução
Force Stop=Forçar parada
Hibernate=Hibernar
Log for=Registo de:
log=registo
Logs=Registos
More Info=Mais informações
No=Não
OK=OK
Ok=Ok
Pause=Pausar
Proceed=Continuar
Project Page=Página do Projeto
Read Me First=Leia-me primeiro
Remove container=Eliminar contêiner
Remove definition=Eliminar definição
Remove image=Eliminar imagem
Remove VM=Eliminar máquina virtual
Remove=Eliminar
Restart=Reiniciar
Resume=Resumir
Start=Iniciar
Stop=Parar
Support=Suporte
Update container=Atualizar contêiner
Update=Atualizar
Updating all Containers=Atualizando todos os contêineres
Updating the container=Atualizando o contêiner
VNC Remote=*VNC* Remoto
WebUI=*Interface Web*
Yes, delete it=Sim, eliminá-lo!
Yes, update it=Sim, atualize-o!
Yes=Sim

; footer messages
Array Copying=Cópia de *Array*
Array Clearing=Limpeza de *Array*
Array Starting=Iniciando *Array*
Array Stopping=Parando *Array*
Mounting disks=Montando discos
Retry unmounting user shares=Retry unmounting user share(s)
Spinning up all drives=Ativando todos os discos
Stale configuration=Configuração obsoleta
Starting services=Iniciando serviços
Stopping services=Parando serviços
Starting Recycle Bin=Iniciando a Lixeira
Stopping Recycle Bin=Parando a Lixeira
Sync filesystems=Sincronizar sistemas de arquivos
Unmounting disks=Desmontando discos
Autostart disabled=Início automático desativado
Missing encryption key=Falta chave de encriptação
Opening encrypted volumes=Abrindo volumes encriptados

; docker variables
Container Path=Caminho do contêiner
Container Port=Porta do contêiner
Container Variable=Variável de contêiner
Container Label=Rótulo do contêiner
Container Device=Dispositivo de contêiner
