%s An update is available=%s: Uma atualização está disponível
anonymous=anônimo(a)
Author=Autor
Check For Updates=Verificar se há Atualizações
Click here to install version %s=Clicar aqui para instalar a versão %s
DOWNGRADE TO VERSION=DOWNGRADE PARA A VERSÃO
Enter URL of remote plugin file or local plugin file=Digitar a *URL* do arquivo remoto do *plugin* ou o arquivo local do *plugin*
ERROR=Erro
Install Plugin=Instalar *plugin*
install=instalar
Install=Instalar
Installed Plugins=*Plugin(s)* instalado(s)
Installing Update=Instalando atualização
need check=precisa ser verificado
Next=Próximo
No release notes available=Não há notas de versão disponíveis
Plugin File=Arquivo do *Plugin*
Plugin Update Check=Procurar por atualização do *plugin*
Plugin=*Plugin*
Release Notes=Notas de Versão
remove=remover
Select local plugin file=Selecionar arquivo de *plugin* local
Stable=Estável
STALE=OBSOLETO
Support Thread=Tópico de suporte no fórum
Uninstall=Desinstalar
Update All Plugins=Atualizar todos os plugins
Upgrade=*Upgrade*
View Release Notes=Ver Notas de Versão

; New entries - 2021-03-14
No plugins installed=Nenhum *plugin* instalado
