Add Share=Adicionar compartilhamento
All files encrypted=Todos os arquivos encriptados
All files protected=Todos os arquivos protegidos
All files unprotected=Todos os arquivos desprotegidos
Allocation method=Método de alocação
Array must be Started to view Shares=*Array* tem de estar **Iniciado** para ver os compartilhamentos
Automatically split any directory as required=Separar automaticamente qualquer pasta conforme necessário
Automatically split only the top five directory levels as required=Separar automaticamente apenas os cinco níveis de pastas principais, conforme necessário
Automatically split only the top four directory levels as required=Separar automaticamente apenas os quatro níveis de pastas principais, conforme necessário
Automatically split only the top level directory as required=Separar automaticamente apenas a pasta de nível superior conforme necessário
Automatically split only the top three directory levels as required=Separar automaticamente apenas os três níveis de pastas principais, conforme necessário
Automatically split only the top two directory levels as required=Separar automaticamente apenas os dois níveis de pastas superiores, conforme necessário
Calculated free space value=
Clean Up=
CLEAN UP=
Comments=Comentários
Compute All=Calcular Todas
Compute=Calcular
Disk Shares=Compartilhamentos de disco
Do not use pool names=Não usar nomes de agrupamentos
Do not use reserved names=Não usar nomes reservados
Enable Copy-on-write=Ativar *Copy-on-write*
Enter a name for the share=Insira um nome para o compartilhamento
Excluded disks=Discos excluídos
Exclusive access=
Export=Exportar
Fill-up=Encher
Free=Livre
has been deleted=foi apagado
HDD=*HDD*
High-water=*High-water*
Included disks=Discos incluídos
Invalid Characters=Carateres inválidos
Invalid share name=Nome de compartilhamento inválido
Manual do not automatically split directories=Manual: não separar pastas automaticamente
Minimum free space=Espaço mínimo livre
Missing share name=Falta o nome do compartilhamento
Most-free=Com mais espaço livre
Mover action=
Mover takes no action=*Mover* não executa nenhuma ação
Mover transfers files from array to cache=*Mover* transfere arquivos do *array* para o *cache*
Mover transfers files from cache to array=*Mover* transfere arquivos do *cache* para o *array*
Mover transfers files from Primary storage to Secondary storage=
Mover transfers files from Secondary storage to Primary storage=
next user share=compartilhamento do próximo usuário
No unused share configurations present=
Not used=
Only=Apenas
Prefer=Prefere
previous user share=Compartilhamento de usuário anterior
Primary storage for new files and folders=Primary storage (for new files and folders)
Primary storage to Secondary storage=
Read=Ler
Recompute=Recalcular
Remove unused share configurations=
Removed share configurations=
Rule=Regra
Secondary storage to Primary storage=
Secondary storage=
Select cache pool=Selecionar agrupamento de *cache*
Set when adding new share only=Configurado apenas ao criar um novo compartilhamento
Share contains data=Compartilhamento contém dados
Share is empty=Compartilhamento está vazio
Share is outside the list of designated disks=O compartilhamento está fora da lista de discos designados
Share Settings=Configurações de compartilhamento
Share status=Status do compartilhamento
Size=Tamanho
Some or all files unencrypted=Todos ou alguns arquivos estão desencriptados
Some or all files unprotected=Todos ou alguns arquivos estão desprotegidos
Split level=Separação de pastas
SSD=*SSD*
Storage=
There are no exportable disk shares=Não há compartilhamentos de disco exportáveis
There are no exportable user shares=Não há compartilhamentos de usuários exportáveis
Time Machine volume size limit=Limite de tamanho de volume do *Time Machine* (Backup)
Unknown encryption state=Estado de criptografia desconhecido
Use cache pool for new filesdirectories=Usar agrupamento de *cache* (para novos arquivos/pastas)
User Shares=Compartilhamentos do usuário
Write=Escrever
You cannot use the following within share names=Você não pode usar o seguinte em nomes de compartilhamento

; Note: April 28, 2023 - 15 missing translations
