20 EHCI=2.0 (EHCI)
30 nec XHCI=3.0 (nec XHCI)
30 qemu XHCI=3.0 (qemu XHCI)
Allocation=Alocação
and if using graphics device passthrough it too needs UEFI=e se utilizar o passthrough do dispositivo gráfico este também precisa de suporte UEFI
Are you sure=Tem a certeza
Array must be started to view Virtual Machines=O array tem de estar **iniciado** para ver as Máquinas Virtuais
Autostart=Arranque automático
Back=Retroceder
Bus=Bus
Capacity=Capacidade
Change Icon=Mudar ícone
Cleanup=Limpar
Click and Select cdrom image to install operating system=Clicar e selecionar o ficheiro da imagem para instalar o sistema operativo
Config Folder=Pasta de configuração
Copy Paste Domain XML Configuration Here=Copiar e Colar Aqui o Ficheiro de Configuração XML
CPU Mode=Modo da CPU
CPUs=CPUs
Create=Criar
Creating=A criar
define the amount memory=definir quantidade de memória
define the maximum amount of memory=definir memória máxima
define type of cpu presented to this vm=definir o tipo de CPU para esta vm
description of virtual machine=descrição da máquina virtual
Disk devices=Dispositivos de disco
Download Folder=Pasta de transferências
Download, Click and Select virtio drivers image=Descarregar, Clicar e Selecionar imagem de controladores virtio
Downloading=A transferir
eg=p. ex.
Emulated=Emulado
ETA=ETA
Extracting=A Extrair
Folder to save the LibreELEC image to=Pasta para guardar a imagem de LibreELEC
Folder to save the OpenELEC image to=Pasta para guardar a imagem de OpenELEC
Form View=Vista de formulário
free=livre
Graphics Card=Placa gráfica
Graphics ROM BIOS=ROM BIOS da placa gráfica
Graphics=Gráficos
Guest not running or guest agent not installed=O convidado não está em execução ou o agente convidado não está instalado
Host Passthrough=Acesso Direto ao Host
Hyperv tweaks for Windows=Ajustes Hyperv para Windows
Hyper-V=Hyper-V
i440fx will work for most=i440fx irá funcionar para a maioria
Icon=Ícone
Initial=Inicial
Interfaces=Interfaces
Invalid storage path=Caminho de armazenamento inválido
Invalid VM to edit=Máquina Virtual a editar inválida
IP Address=Endereço *IP*
ISO storage path doesnt exist, please create the user share or empty folder first=O caminho de armazenamento ISO não existe, crie o compartilhamento de usuário (ou pasta vazia) primeiro
ISO storage path doesnt exist=O caminho de armazenamento de imagens ISO não existe
ISO storage path was empty=O caminho de armazenamento de imagens ISO estava vazio
keyboard for VNC=teclado para VNC
LibreELEC Version=Versão de LibreELEC
LibreELEC=LibreELEC
Libvirt Service failed to start=Não foi possível iniciar o Serviço LibreELEC
Logical CPUs=CPUs lógicos
Machine=Máquina
Manual=Manual
Max=Máxima
MD5 verification failed, your download is incomplete or corrupted=A verificação MD5 falhou, o seu download está incompleto ou corrompido
mount tag inside vm=etiqueta de montagem dentro da vm
My Workstation=Meu posto de trabalho
name of mount tag inside vm=nome da etiqueta de montagem dentro da vm
Name of virtual machine=Nome da máquina virtual
Network Bridge=Ponte de rede
Network MAC=Endereço físico (MAC)
Network Model=Modelo de rede
No Virtual Machines installed=Sem Máquinas Virtuais instaladas
None available=Nenhum disponivel
Not enough free space, need at least=Não há espaço livre suficiente, é necessário pelo menos
Not running=Não está em execução
OpenELEC Version=Versão OpenELEC
OpenELEC=OpenELEC
OS Install CDRom Bus=Bus do CDRom para instalação do SO
OS Install ISO=ISO de instalação do SO
Other PCI Devices=Outros dispositivos PCI
OVMF requires a UEFI-compatable OS=OVMF requer um SO compatível com UEFI
OVMF TPM=OVMF TPM
OVMF=OVMF
password for VNC=senha para VNC
path of Unraid share=caminho da partilha Unraid
path on Unraid share to save LibreELEC settings=caminho da partilha Unraid para guardar definições do LibreELEC
path on Unraid share to save OpenELEC settings=caminho da partilha Unraid para guardar definições do OpenELEC
Path to ROM BIOS file=caminho para o ficheiro ROM BIOS
Please choose a folder the LibreELEC image will download to=Por favor escolha uma pasta para descarregar a imagem LibreELEC
Please choose a folder the OpenELEC image will download to=Por favor escolha uma pasta para descarregar a imagem OpenELEC
Pop-up Blocker is enabled Please add this site to your exception list=O bloqueador de pop-ups está ativado! Por favor, adicione este site à sua lista de exceções
Prefix=Prefixo
Primary=Primário
Q35 for a newer machine model with PCIE=Q35 para um modelo de máquina mais recente com PCIE
QEMU64=QEMU64
random mac, you can supply your own=mac aleatório, pode fornecer o seu próprio
re-generate random mac address=gerar de novo um endereço mac aleatório
Remove LibreELEC image=Remover a imagem de LibreELEC
Remove OpenELEC image=Remover a imagem de OpenELEC
Remove this LibreELEC file=Remover este ficheiro LibreELEC
Remove this OpenELEC file=Remover este ficheiro OpenELEC
SeaBIOS will work for most=SeaBIOS irá trabalhar para a maioria
SeaBIOS=SeaBIOS
Select the BIOS=Selecionar a BIOS
Select the LibreELEC version to use=Selecionar a versão LibreELEC a utilizar
Select the machine model=Selecionar o modelo da máquina
Select the OpenELEC version to use=Selecionar a versão OpenELEC a utilizar
Select the USB Controller to emulate=Selecionar o Controlador USB para emular
Separate sub-folder and image will be created based on Name=Subpasta e imagem separadas serão criadas com base no Nome
shares=compartilhamento
Some OSes wont support USB3=Alguns sistemas operativos não suportam USB3
Sound Card=Placa de som
Specify a ISO storage path first=Especifique primeiro um caminho de armazenamento ISO
Start All=Iniciar tudo
Start VM after creation=Iniciar a VM após a criação
Stop All=Parar tudo
Toggle VM autostart=Alternar auto-arranque da VM
type of storage image=tipo de imagem de armazenamento
Unknown action=Ação desconhecida
Unknown version=Versão desconhecida
Unraid Mount tag=Etiqueta de montagem Unraid
Unraid Share=Compartilhamento do Unraid
Updating=Atualizando
USB Controller=Controlador USB
USB Devices=Dispositivos USB
vDisk Bus=Bus do vDisk
vDisk Location=Localização do vDisk
vDisk Size=Capacidade do vDisk
vDisk Type=Tipo de vDisk
vDisks=vDisks
Verifying=Verificando
video for VNC=vídeo para VNC
VirtIO Drivers CDRom Bus=Bus do CDRom para controladores VirtIO
VirtIO Drivers ISO=Imagem de controladores VirtIO
Virtual Machines=Máquinas Virtuais
VM creation error=Erro na criação de VM
VM image deletion error=Erro ao eliminar a VM
VNC Keyboard=Teclado VNC
VNC Password=Senha VNC
VNC Video Driver=Controlador de Vídeo VNC
VNC=VNC
Wasnt able to stop the process=Não foi possível parar o processo
Windows 7XP=Windows 7/XP
Windows 82012, newer Linux distros=Windows 8/2012, distribuições Linux mais recentes
XML View=Visualização XML

; Note: April 29, 2023 - 34 missing translations
9p Mode=
Boot Order=
Boot order=
define OS boot options=
Eject CD Drive=
Enable USB boot=
Guest agent not installed=
Guest not running=
Insert CD=
Insert=
ISO Image=
Lock sortable items=
Network Source=
No CD image inserted in to drive=
Optional=
port for virtual console=
protocol for virtual console=
Select=
Serial=
Unlock sortable items=
Unraid Mount Tag=
Unraid Share Mode=
Unraid Source Path=
Virtiofs Mode=
Virtual=
VM Console AutoPort=
VM Console enable Copypaste=VM Console enable Copy/paste
VM Console Keyboard=
VM Console Password=
VM Console Port=
VM Console Protocol=
VM Console Video Driver=
VM Console WS Port=
wsport for virtual console=
